1111111111
1222222231
1225252231
1022222228
1226225221
1222121221
1111141111
