g111171111
1222121221
1626222261
1222222221
1626222228
1222222221
1111111111
