f111111111
1252522101
1222222221
1252525251
9222222221
1111111111
