2222222221
1111111111
1233322221
9333222331
1222333338
1111111111
1222222221
