h111111111
1221125551
1215252231
1222222221
9222223331
1222223331
1111111111
